            
     ###    
  ####E#### 
  #.......# 
  #.......# 
  #.......# 
  #.......# 
  #.......# 
  #.......# 
  ######### 
            
             